Ms^Xm, Aa, Ms^Xm, Aa, Ms^Xm, Ms^Xm, Ms^Xm, Ms^Xm, Ms^Xm, Xu, Xu, Wog, Wog, Xuc, Xuc, Xu, Xuc, Xu, Xu, Xu, Xuc, Xu, Xu, Xu, Xu, Xu, Xu, Xu, Xu, Xu, Xu, Xu, Xu, Xu, Xu, Xu, Xu, Xu, Xu, Xu, Xu, Xu, Xu, Ms^Xm, Ms^Xm, Ms^Xm, Ms^Xm, Ms^Xm, Ms^Xm, Ms^Xm, Ms^Xm, Ms^Xm, Ms^Xm, Ms^Xm, Ms^Xm
Ms^Xm, Ms^Xm, Ms^Xm, Ms^Xm, Ms^Xm, Ms^Xm, Ms^Xm, Ms^Xm, Ms^Xm, Ms^Xm, Xu, Wog, Wog, Wog, Wwg, Xuc^Efs, Ww, Xuc^Efs, Xuc, Xuc, Ww, Xuc, Xuc, Xu, Xu, Xu, Xu, Xu, Xu, Xu, Xu, Xu, Uu^Vud, Xu, Xu, Xu, Xu, Xu, Xu, Xu, Xu^Efs, Xu, Xu, Xu, Ms^Xm, Ms^Xm, Ms^Xm, Ms^Xm, Ms^Xm, Ms^Xm, Ms^Xm, Ms^Xm, Ms^Xm, Ms^Xm, Ms^Xm
Ms^Xm, Ms^Xm, Ms^Xm, Ms^Xm, Ms^Xm, Ms^Xm, Ms^Xm, Ms^Xm, Ms^Xm, Ms^Xm, Ms^Xm, Xu, Xu, Wwg, Wwg, Wog, Uh, Cud, Wwf, Wwf, Rb^Emf, Ww, Ww, Uu^Tf, Cud, Xom, Xom, Xu, Xom, Xom, Cud, Urb, Urb, Uu^Es, Urb, Uh, Rb^Es, Xu, Uu^Tf, Uu, Uu^Es, Xu, Xu, Xu, Ms^Xm, Ms^Xm, Ms^Xm, Ms^Xm, Ms^Xm, Ms^Xm, Ms^Xm, Ms^Xm, Ms^Xm, Ms^Xm, Ms^Xm
Ms^Xm, Ms^Xm, Ms^Xm, Ms^Xm, Ms^Xm, Ms^Xm, Ms^Xm, Ms^Xm, Ms^Xm, Ms^Xm, Ms^Xm, Ms^Xm, Xu, Rb, Wwg, Wog, Wog, Wwf, Rb^Emf, Rb^Emf, Wwf, Wwf, Rb^Emf, Uu, Cud, Xom^Efs, Xom^Efs, Xom, Xom^Efs, Xom^Efs, Cud, Uu, Urb, Urb, Urb, Uu^Es, Uu^Ii, Uu, Urb, Urb, Uh^Es, Xu, Xu, Xu, Ms^Xm, Ms^Xm, Ms^Xm, Ms^Xm, Ms^Xm, Ms^Xm, Ms^Xm, Ms^Xm, Ms^Xm, Ms^Xm, Ms^Xm
Ms^Xm, Ms^Xm, Ms, Ms^Xm, Ms, Ms^Xm, Ms^Xm, Ms^Xm, Ms^Xm, Ms^Xm, Ms^Xm, Ms^Xm, Xu, Uu^Es, Wwg, Wog, Wwg, Wwg, Wwg, Wwf, Rb^Emf, Rb^Emf, Wwf, Uu, Cud, Cud, Cud, 1 Kud, Cud, Cud, Cud, Uu, Urb, Uu^Es, Uu, Urb, Urb, Urb, Uh, Uh, Xu, Xu, Xu, Ms^Xm, Ms^Xm, Ms^Xm, Ms^Xm, Ms^Xm, Ms^Xm, Ms^Xm, Ms, Ms^Xm, Ms, Ms^Xm, Ms
Ms, Ms, Ha, Ha^Esa, Ha^Esa, Ms, Ms, Ms^Xm, Ms^Xm, Ms^Xm, Ms^Xm, Ms^Xm, Xu, Uu^Tf, Wwg, Wwg, Wwg^Ii, Wwg^Ii, Wwg^Ii, Wwg, Wwf, Wwf, Rb^Emf, Uu, Uu, Cud^Ebn, Uu, Cud, Uu, Cud^Ebn, Uu^Es, Uu^Es, Urb, Uu, Uu^Ii, Uu^Tf, Uh, Urb, Urb, Uu^Vu, Uh, Xu, Xu, Ms^Xm, Ms^Xm, Ms^Xm, Ms^Xm, Ms^Xm, Ms, Ms, Ha^Esa, Ha^Esa, Ha^Es, Ms, Ms
Ha, Ha, Ha, Ha, Ha, Ms, Ms, Ms^Xm, Ms^Xm, Ms^Xm, Ms^Xm, Ms^Xm, Xu, Wwf, Wwg, Wwg, Wwg^Ii, Wwg^Ii, Wwg^Ii, Wwg, Rb^Tf, Rb^Emf, Uu, Uu^Es, Uu^Vud, Uu, Ur, Urb, Ur, Uu, Uu^Vud, Uu, Urb, Uu^Vud, Ur, Uu, Xuc, Uh, Uu, Urb, Uu^Es, Xu, Xu, Ms^Xm, Ms^Xm, Ms^Xm, Ms^Xm, Ms, Ms, Ms, Ha, Ha^Es, Ha^Esa, Ha, Ha
Ha, Ha, Aa^Fma, Aa, Aa^Fpa, Ha, Ms, Ms^Xm, Ms^Xm, Ms^Xm, Xu, Xu, Xuc, Xuc, Cud, Wwg, Wwg, Wwg^Ii, Wwg, Wwg, Wwg, Xuc^Efs, Xuc, Uu^Es, Ur, Ur, Cud, Urb, Cud, Ur, Ur, Uu, Xuc, Xuc^Efs, Ur, Uu^Es, Rb, Uh, Uu^Es, Urb, Xuc^Efs, Xuc, Xuc^Efs, Xu, Xu, Xu, Xu, Ms^Xm, Ms, Ha, Aa, Aa^Esa, Aa^Esa, Ha^Esa, Ha
Aa, Aa^Es, Aa^Fda, Aa^Feta, Aa^Esa, Ha, Ha, Ms, Ms^Xm, Ms^Xm, Xu, Uh, Uh, Xuc^Efs, Wwg, Cud^Ebn, Cud, Wwg, Xuc, Wwg, Cud^Ii, Cud, Ur, Uu^Vud, Ur, Uu^Ebn, Urb^Ii, Urb, Urb, Uu^Ebn, Ur, Uu^Vud, Ur, Cud, Cud^Ii, Uu^Es, Xuc, Rb, Xuc, Urb, Uh, Xuc, Uh, Uh, Xu, Xu, Xu, Ms^Xm, Ha, Ha, Aa^Esa, Aa, Aa^Es, Aa^Esa, Aa
Aa^Esa, Aa^Esa, Aa, Aa^Esa, Aa^Esa, Aa, Ha, Ms, Ms, Ms^Xm, Xu, Uh, Uu^Tf, Wwg, Wwg, Rb, Uh, Xuc^Efs, Xuc, Cud, Wwg, Uh, Uh, Ur, Uu^Es, Ur, Cud, Urb, Cud, Ur, Uu, Ur, Uh, Uh, Uu, Cud, Xuc, Xuc^Efs, Uh, Urb, Uu, Uu, Uu^Tfi, Rb, Xu, Xu, Ms^Xm, Ms^Xm, Ha, Aa^Esa, Aa^Esa, Aa^Es, Aa^Esa, Aa, Aa
Aa, Aa, Aa^Es, Aa, Aa, Aa^Es, Ha, Ha, Ha^Esa, Ms, Xu, Uu, Uu^Es, Rb, Wwg, Uu, Uu, Uh, Uh, Uh, Wwg, Uh, Rb, Uu, Uu, Uu^Es, Urb, Urb, Urb^Ii, Uu, Uu^Tf, Uu, Uu^Es, Uh, Uu, Uh, Uh, Uh^Ii, Uu, Urb, Urb, Uu^Vu, Uu, Rb, Xu, Ms^Xm, Ms^Xm, Ms^Xm, Aa^Esa, Aa, Aa, Aa, Aa^Esa, Aa^Esa, Aa
Aa, Aa^Es, Gd, Gd, Re, Aa^Es, Ha, Ha^Esa, Ha^Esa, Ha, Uh, Rb, Uu^Es, Rb, Wwg, Cud, Wwg, Rb, Wwg, Wwg, Rb, Uu^Es, Rb, Uh, Xuc, Uu^Ebn, Urb, Urb, Urb, Uu^Ebn, Xuc, Uh, Uu^Es, Uu^Vud, Urb, Uu^Es, Uu^Es, Uu^Tf, Urb, Urb, Uu, Urb, Urb, Uh, Uh, Ha, Ha, Aa^Esa, Aa^Esa, Aa^Es, Re, Gd, Gd, Aa, Aa
Aa, Re, Cea, Cea, Cea, Aa, Aa, Ha, Ha, Ha, Ha^Esa, Uh, Uu, Wwg, Uu^Es, Uh, Wwg, Wwg, Uu, Rb, Uu^Vu, Uu^Tf, Uu, Uu^Es, Xuc, Cud, Urb^Ii, Urb, Urb, Cud, Xuc, Xuc, Xuc^Efs, Uu, Uu, Urb, Urb, Urb, Xuc^Efs, Urb, Uu^Es, Uu^Tf, Uh, Urb, Ha^Esa, Ha^Esa, Ha, Aa, Aa^Es, Aa^Es, Cfa, Cfa, Ce, Re, Aa
Aa, Re^Es, Cea, 2 Kea, Cea, Cea, Aa, Ha, Ha^Vhha, Ha^Esa, Ha^Esa, Uh, Xu, Wwg, Uh^Tf, Wwg, Rb^Es, Uu^Es, Cud, Uu, Uu, Uu, Uh, Uu^Tf, Xuc^Efs, Uu^Vud, Urb, Urb, Urb, Uu^Vud, Xuc^Efs, Xuc, Uh, Rb, Rb, Uu^Ebn, Cud, Urb, Urb, Urb, Uu, Uh, Xu, Xu, Ha, Ha^Esa, Ha^Vhha, Ha, Aa^Esa, Cfa, Cfa^Esa, 3 Kfa, Ce, Re, Aa
Aa, Re, Gd^Es, Cea, Cea, Cea, Re, Aa, Ha, Ha, Aa, Ha, Wwg, Wwg, Xu, Wwg, Uu, Rb, Uh, Cud, Uu, Uh, Xuc, Xuc^Efs, Qxu, Cud, Urb, Urb, Urb^Ii, Cud, Qxu, Xuc^Efs, Xuc, Uh, Uu, Cud, Uh, Uu^Es, Uu^Es, Urb, Uh, Xu, Ms^Xm, Ms^Xm, Ms^Xm, Ha, Ha, Aa^Esa, Re, Cfa^Esa, Ce^Esa, Ce^Esa, Gd, Re, Aa
Aa, Aa, Aa^Vca, Re, Re, Gd, Re, Aa, Aa^Fda, Aa^Fma, Aa, Wwg, Ha, Ha^Esa, Wwg, Wwg, Uh, Uu^Tf, Uu, Uh, Xu, Xuc, Xu, Uu, Uu^Vu, Qxu, Urb^Ii, Urb, Urb, Qxu, Uu^Vu, Uu, Xu, Xuc, Xu, Uh, Rb, Rb^Es, Uu^Tf, Urb, Uh, Ha, Ha, Ms^Xm, Ha, Ha^Fpa, Aa^Fpa, Aa, Re, Gd, Re^Es, Re, Aa^Vca, Aa^Es, Aa
Aa, Aa, Aa^Es, Aa^Es, Aa^Esa, Aa^Esa, Aa, Re, Aa, Aa^Fpa, Aa, Wwg, Ha, Ha^Esa, Wwg, Hhd, Hhd^Esa, Uh, Uh, Xu, Ms^Xm, Xu, Xu, Uu, Uue, Uu^Tf, Uu^Es, Urb, Uu^Es, Uu^Tf, Uue, Uu, Xu, Xu, Ms^Xm, Xu, Xu, Uu, Uh, Urb, Ha, Ha, Ha, Ha, Ha, Ha^Fpa, Aa^Esa, Re, Aa, Aa^Es, Aa^Es, Aa, Aa^Esa, Aa, Aa
Aa, Aa^Esa, Aa^Esa, Aa, Aa, Aa, Aa^Fda, Aa, Aa^Esa, Re, Wwg^Bw\, Wwg, Aa^Vca, Wwg, Aa, Ha^Esa, Ha^Esa, Hhd, Ha, Ms^Xm, Ms^Xm, Ms^Xm, Ms^Xm, Xu, Xu, Uue, Uue, Urb, Uue, Uue^Ii, Xu, Xu, Ms^Xm, Ms^Xm, Ms^Xm, Ms^Xm, Ms^Xm, Xu, Ha, Ha, Aa, Ha, Ha^Vhha, Aa, Rd, Rd, Aa^Esa, Aa^Esa, Aa^Fpa, Aa, Aa, Aa^Esa, Aa^Esa, Aa, Aa
Aa, Aa^Esa, Aa^Es, Aa^Es, Aa^Esa, Aa^Esa, Aa, Aa, Aa, Aa^Esa, Wwg, Aa, Wwg^Bw\, Wwg, Aa^Esa, Aa, Aa, Ha, Aa^Esa, Aa^Esa, Aa, Ms^Xm, Ha, Ms^Xm, Xu, Uue^Ii, Re, Ur^Es, Re^Es, Re, Xu, Ms^Xm, Ms, Ms^Xm, Ha^Es, Ms^Xm, Aa, Ha, Aa, Aa^Esa, Aa^Esa, Aa, Ha, Ha, Ms, Aa, Aa^Es, Aa, Aa^Esa, Aa^Esa, Aa, Aa, Aa, Aa, Aa
Aa, Aa, Aa, Aa^Es, Aa, Aa^Esa, Aa, Aa^Es, Aa^Es, Wwg, Wwg, Wwg, Aa, Re, Re, Gd^Esa, Gd^Fms, Aa, Aa, Aa^Esa, Aa^Es, Aa, Aa^Esa, Ha, Gd, Re, Re^Es, Ur, Rd, Rd^Es, Re, Ha, Ha^Esa, Ha, Aa, Aa^Es, Aa^Esa, Aa, Gd^Fp, Gd^Esa, Re, Re, Aa^Esa, Ms, Ms, Ms, Ha, Aa^Es, Aa, Aa, Aa^Esa, Aa, Ha, Ha, Ha
Wwg, Wwg, Wwg, Aa, Aa, Aa, Aa, Aa^Es, Ai, Wwg, Ai, Ai^Esa, Gd^Esa, Rb, Gd^Fms, Re, Re, Re, Re, Aa, Aa^Es, Aa^Es, Aa^Esa, Rd^Esa, Gd, Re^Es, Re^Esa, Re, Gd^Esa, Gd^Esa, Gd, Gd^Esa, Aa^Esa, Aa^Esa, Aa^Esa, Aa^Esa, Re^Esa, Re, Re, Re, Gd^Fp, Rb^Esa, Rd^Esa, Ha, Ha, Ms, Ms^Xm, Ha, Ha, Aa^Esa, Ha^Esa, Ha, Ms, Ms, Ms
Wwg, Wwg, Ai^Esa, Wwg, Wwg, Aa, Wwg, Ai, Wwg, Wwg, Ai, Aa^Esa, Aa^Es, Gd, Gd^Fp, Aa^Fdw, Aa^Fda, Aa^Fma, Aa^Esa, Re, Re, Aa, Re, Re, Re, Gd^Esa, Rd^Esa, Re, Rd^Esa, Rd^Esa, Re^Es, Re^Es, Re, Aa^Es, Re, Re, Aa, Aa^Fpa, Aa^Fpa, Aa^Fp, Gd^Fp, Gd, Aa, Aa, Ha, Ms, Ms, Ms, Ms, Ha, Ms, Ms, Ha, Ms, Ms
Ai, Aa, Aa^Esa, Ai, Wwg, Wwg, Wwg, Wwg, Wwg, Wwg, Aa^Esa, Aa, Aa, Aa^Fpa, Aa^Fda, Aa^Fmw, Aa^Fpa, Aa, Aa^Esa, Aa^Esa, Re^Vct, Re^Vct, Cea, Re^Vct, Ce^Esa, Re, Re, Re, Re, Re, Ce^Esa, Re^Vct, Cea, Re^Vct, Re^Vct, Aa, Aa^Esa, Aa^Esa, Aa^Fpa, Aa^Fp, Aa^Fpa, Aa^Fpa, Aa, Aa, Aa^Esa, Ms, Ms, Ms, Ms, Ms, Ms, Ha, Aa^Esa, Ha, Ha
Ai, Ai, Ai, Ai, Ai, Ai, Ai, Ai^Esa, Aa^Esa, Aa, Aa^Es, Aa, Aa, Aa^Fpa, Aa^Fpa, Aa^Fma, Aa^Esa, Aa, Aa, Aa, Aa, Re^Vct, Kea, Cea^Esa, Ce, Ce, Cea, Cea, Cea, Ce^Esa, Ce, Cea, Kea, Re^Vct, Aa, Aa, Aa, Aa^Esa, Aa, Aa^Fpa, Aa^Fpa, Aa^Fpa, Aa, Aa^Esa, Aa^Esa, Aa^Esa, Aa, Ha, Ha, Ha, Ha, Ha^Esa, Ha^Esa, Ha^Esa, Ha
Aa, Aa^Esa, Aa^Esa, Aa, Aa^Esa, Aa^Esa, Ai, Ai^Esa, Aa, Aa^Es, Aa^Esa, Aa^Esa, Aa, Aa^Es, Aa^Es, Aa^Esa, Aa^Esa, Aa, Aa, Aa^Esa, Aa^Esa, Aa, Re, Re, Aa, Aa, Re, 4 Kea, Re, Aa^Esa, Aa^Esa, Re^Es, Re^Es, Aa, Aa, Aa^Esa, Aa^Esa, Aa, Aa, Aa^Esa, Aa^Esa, Aa, Aa^Esa, Aa, Aa, Aa, Aa, Ha, Ha, Aa^Esa, Aa^Esa, Aa, Aa, Aa, Aa
Aa, Aa^Esa, Aa, Aa, Aa, Aa^Esa, Aa, Aa, Aa, Aa, Aa, Aa^Esa, Aa, Aa^Es, Aa, Aa, Aa, Aa, Aa, Aa^Esa, Aa, Aa, Aa, Gd, Gd, Gd, Re, Rp, Gd, Gd^Esa, Gd, Gd, Aa, Aa, Aa, Aa^Esa, Aa, Aa, Aa, Aa^Esa, Aa, Aa, Aa, Aa, Aa^Esa, Aa^Esa, Aa, Aa, Aa, Aa^Esa, Aa, Aa, Aa, Aa, Aa
Aa, Aa, Aa, Aa, Aa, Aa, Aa, Aa, Aa, Aa, Aa, Aa, Aa, Aa, Aa, Aa, Aa, Aa, Aa, Aa, Aa, Aa, Aa, Aa, Aa, Gd, Gd, Rp, Gd, Re, Aa, Aa, Aa, Aa, Aa, Aa, Aa, Aa, Aa, Aa, Aa, Aa, Aa, Aa, Aa, Aa, Aa, Aa, Aa, Aa, Aa, Aa, Aa, Aa, Aa
